1111111111111
10011000000C1
1000001111001
1P0011E000011
1111111111111